R 2100 1100

F 0,100,25 

NO ./textures/bleu.xpm
SO ./textures/bleu.xpm
EA ./textures/bleu.xpm
WE ./textures///bleu.xpm

C 1,50,2



11111111111111111           1
100000000000000011111111111101111111111111
100000002000000122222222200000002222222221
100000000000000012222222222202222222222221
100020002000200010000000000000000000000001
100000000000000000000000000000000000000001
102020200020202010000000000000000000000001
1011111111111111111111111111111111111110001      1111111111111
101111111111111110000000000000000000000001       10000000000001
10000000000000000000000000000N000000000111       10000000000001
100020002002000012222222222002222222222221       1111111111111
100000000000000012222222200000022222222221
102000002000020011111111111011111111111111
10000000000000001          1
11111111111111111
1111111
10000001
100020001
1000000001             111
1111111111             101
                       111  